12
4
3
11111111111111111111111111111
10000000000000000000000000001
10000000000000000000000000001
10001111000000000000000000001
10001111000000000000000000001
10000011111111111111100000001
10000011111111111111100000001
10001111000000000000000000001
10001111000000000000000000001
10000000000000000000000000001
10000000000000000000000000001
11111111111111111111111111111
