10
4
2
1111111111111111111111111111111111111111111111111111111111111
1001000101001000101001000101001000101001000101001000101001011
1001000101001000101001000101001000101001000101001011001000101
1100000001001000101001000101001000101001000101001000101001011
1000000000000000000000000000000000000000000000000000000000001
1000011001001000101001000101001000101001000101001000101001011
1001000101001000101001000101001000101001000101001011001001001
1101111001001000101001000101001000101001000101001000101001011
1001000101001000101001000101001000101001000101001011000000001
1111111111111111111111111111111111111111111111111111111111111